NO ./path_to_the_north_texture
SO ./path_to_the_south_texture
WE ./path_to_the_west_texture
EA ./path_to_the_east_texture

F 1,0,0
C 225,1,0


111111111
11111111111111
10100000000001
10000000111111
100000001
111111111
